111111111111111111111111111111
11X000000000000C00P00C00000001
10100101X01000X010100100010101
101001001010101000100100X10101
1X0000000C00C000000000000000E1
111111111111111111111111111111